8 9 24
6 6 6 6 6 6 6 6 6
6 6 0 0 0 0 6 6 6
6 6 2 6 5 5 0 0 6
6 0 5 6 6 3 3 3 6
6 0 0 6 6 0 5 0 6
6 1 0 6 6 0 2 0 6
6 6 6 6 6 4 0 2 6
6 6 6 6 6 6 6 6 6